1111111111111
10000001111C1
1P00000000CC1
100011EE00001
1111111111111