11111111111111111111111111
11111111111111111111111111
11111111111111111111111111
11111111111111111111111111
11111111111111111111111111
11111111111111111111111111
11111111111111111111111111
11111111111111111111111111
1111111PPPPPPPPPPPP1111111
11111111111111111111111111
1111EEEEEEEEEEEEEEEEEEE111
1111111111111111111E111111
111CCCCCCCCCC1111E1P111111
11111EEEEEE11111111C111111
11111111111111111111111111
11111111111111111111111111
1111PPPPPPPPPPPPPPP1111111
11111111111111111111111111
111CCCCCCCCCCCC11111111111
11111111111111111111111111
11111111111111111111111111