1111111111111111111111111111111111
1E00000000D0000C00000C000000000001
1010010100100000101001000000010101
1010010010101010001001000000010101
10P000000C00C000000D000000000000C1
1111111111111111111111111111111111